@ . . . . . . . . .
. . . . . . . . . .
. . . . . . . . . .
. . . . . . . . . .
. . . . . . . . . .
# # # # # # . # # #
. . . . . . . . . .
. . . . . . . . . .
. . $ . . . . . . .
. . . . . . . . . .